###########
#S........#
#.#######.#
#.#.....#.#
#.#.###.#.#
#.#.#G#.#.#
#.#.###.#.#
#.#.....#.#
#.#######.#
#.........#
###########
