#################
#S..#...........#
###.#.#########.#
#...#.#.......#.#
#.###.#.#####.#.#
#.....#.#...#.#.#
#######.#.#.#.#.#
#.......#.#.#.#.#
#.#######.#.#.#.#
#.........#.#...#
###########.###.#
#...........#...#
#.###########.###
#.............#G#
#################
