#######
#S...G#
#.##..#
#.....#
#######
